100000000000
600009999000
000009999000
000009999000
000000000002
